sujet;sexe;age;profPere;profMere;etablissement;classes;scolarite;fran;math;examinateur;vocComp;vocExpr;morpho;sens;vocabulaire;phrases;total
1;1;11,4;Intermédiaire;Sans activité;A;6;AN;79,3;79,2;40;62;64;27;19;126;46;172
2;0;12,1;Ouvrier;Employés;A;6;AR;70,1;62,3;48;50;40;31;34;90;65;155
3;1;13,1;Employés;Employés;A;6;AR;67,8;66,2;40;78;63;34;33;141;67;208
4;1;12,7;Employés;Employés;A;6;AR;58,6;46,8;47;52;37;30;26;89;56;145
5;1;11,6;CadresProfSup;Sans activité;A;6;AN;70,1;79,2;47;70;51;36;31;121;67;188
6;1;11,6;Employés;Sans activité;A;6;AN;55,2;55,8;46;48;46;19;19;94;38;132
7;1;11,4;Agriculteur;Agriculteur;A;6;AN;67,8;49,4;37;52;34;33;31;86;64;150
8;0;11,2;Agriculteur;Intermédiaire;A;6;AN;52,9;35,1;48;50;26;8;28;76;36;112
9;1;11,5;Employés;Employés;A;6;AN;48,3;53,2;47;30;17;22;14;47;36;83
10;1;11,5;CadresProfSup;CadresProfSup;A;6;AN;95,4;93,5;37;72;69;39;38;141;77;218
11;1;12,5;Employés;Intermédiaire;A;6;AR;49,4;40,3;48;62;29;16;30;91;46;137
12;0;11,4;Employés;Intermédiaire;A;6;AN;73,6;71,4;46;65;60;24;36;125;60;185
13;0;11,6;Employés;Sans activité;A;6;AN;69;55,8;47;68;40;23;16;108;39;147
14;0;11,2;CadresProfSup;Intermédiaire;A;6;AN;58,6;39;46;35;54;23;26;89;49;138
16;1;11,3;Intermédiaire;Employés;A;6;AN;68,8;65,5;48;48;46;32;29;94;61;155
17;1;11,3;Ouvrier;Employés;A;6;AN;59,8;66,2;37;55;17;18;17;72;35;107
18;0;11,8;Employés;Employés;A;6;AN;80,5;84,4;31;40;31;34;31;71;65;136
19;1;12,4;Employés;Sans activité;A;6;AR;70,1;79,2;32;52;34;31;31;86;62;148
20;0;12,9;Employés;Employés;A;6;AR;31;35;33;40;0;12;13;40;25;65
21;0;13,9;Sans activité;Sans activité;A;6;AR;59,8;37,7;38;78;57;30;34;135;64;199
22;0;11,8;Sans activité;Employés;A;6;AN;70,2;79,2;32;45;37;27;24;82;51;133
23;1;11,7;Employés;Intermédiaire;A;6;AN;56,3;49,4;38;50;39;28;28;89;56;145
24;1;12,7;Sans activité;Agriculteur;A;6;AR;57,5;62,3;36;45;40;28;28;85;56;141
25;1;11,8;Employés;Employés;A;6;AN;65,5;67,5;34;35;29;28;31;64;59;123
26;0;12,3;Intermédiaire;Intermédiaire;A;6;AR;56,6;63,6;33;52;26;20;22;78;42;120
27;0;11,7;Retraité;Sans activité;A;6;AN;72,4;51,9;31;58;34;28;30;92;58;150
28;0;11,2;Ouvrier;Employés;A;6;AN;70,1;50,6;38;58;31;28;31;89;59;148
29;1;11,2;Employés;Employés;A;6;AN;49,4;80,5;34;32;17;20;19;49;39;88
30;0;13;Employés;Employés;A;6;AR;57,5;71,4;32;55;31;17;24;86;41;127
31;1;11,6;CadresProfSup;CadresProfSup;A;6;AN;42,5;46,8;36;50;26;16;15;76;31;107
32;1;11,6;CadresProfSup;Retraité;A;6;AN;73,6;89,6;31;52;20;33;29;72;62;134
33;1;12,8;Ouvrier;Intermédiaire;A;6;AR;48,3;63,6;34;40;14;27;28;54;55;109
34;1;11,7;Employés;Employés;A;6;AN;66,7;50,6;34;35;40;37;28;75;65;140
35;0;13,1;Employés;Employés;A;6;AR;49,4;33,8;32;25;11;13;15;36;28;64
36;1;12,1;CadresProfSup;Intermédiaire;D;6;AN;84;83,3;10;60;49;33;41;109;74;183
37;1;10,6;CadresProfSup;Sans activité;D;6;AN;84,7;89,7;5;60;54;39;38;114;77;191
39;0;11,6;Ouvrier;Ouvrier;C;6;AN;48;40;26;32;29;22;21;61;43;104
40;1;11,9;CadresProfSup;CadresProfSup;C;6;AN;76;77;26;68;69;40;40;137;80;217
41;1;11,5;CadresProfSup;CadresProfSup;C;6;AN;67;86;26;48;49;28;25;97;53;150
42;1;12,6;CadresProfSup;Sans activité;C;6;AR;64;68;25;52;37;40;38;89;78;167
43;0;12,3;Intermédiaire;Ouvrier;C;6;AN;84;87;25;65;51;31;38;116;69;185
44;1;13,3;Agriculteur;Ouvrier;C;6;AR;52;55;25;62;31;37;32;93;69;162
45;0;12,2;Intermédiaire;Sans activité;C;6;AN;92;78;25;60;49;41;41;109;82;191
46;0;13,3;Ouvrier;Ouvrier;C;6;AR;57;61;23;45;37;19;28;82;47;129
47;1;12,2;Ouvrier;Ouvrier;C;6;AN;47;58;23;32;31;29;32;63;61;124
48;0;11,5;Ouvrier;Ouvrier;C;6;AN;54;44;23;58;29;14;25;87;39;126
49;1;12,3;Employés;Employés;C;6;AN;61;84;23;65;49;33;39;114;72;186
50;0;12,3;Intermédiaire;Intermédiaire;C;6;AN;62;60;24;45;37;27;34;82;61;143
51;1;12,2;Intermédiaire;Sans activité;C;6;AN;69;69;24;42;43;35;40;85;75;160
52;0;13,3;Employés;Ouvrier;C;6;AR;52;34;24;38;17;16;19;55;35;90
53;0;12,5;Ouvrier;Sans activité;C;6;AN;52;51;24;38;11;32;28;49;60;109
54;1;12;Intermédiaire;Employés;C;6;AN;78;74;24;60;57;34;20;117;54;171
55;1;11,6;Intermédiaire;ArtCommPME;C;6;AN;55;70;28;35;31;29;29;66;58;124
56;0;11,6;ArtCommPME;ArtCommPME;C;6;AN;69;47;28;60;43;24;18;103;42;145
57;1;12,8;Ouvrier;Ouvrier;C;6;AR;54;61;28;62;40;36;38;102;74;176
58;0;11,1;Employés;Employés;C;6;AN;64;60;28;50;26;32;32;76;64;140
59;1;12,2;Ouvrier;Ouvrier;C;6;AN;64;68;28;40;40;19;20;80;39;119
61;0;12,3;Employés;Sans activité;D;6;AN;74,1;84,6;11;60;57;22;29;117;51;168
62;1;12,2;CadresProfSup;Employés;D;6;AN;64,7;79,5;6;48;43;28;23;91;51;142
63;0;12,3;Employés;Employés;D;6;AN;83,5;80,8;10;60;54;29;38;114;67;181
65;1;13,4;Intermédiaire;Employés;D;6;AR;82,4;83,3;18;58;46;36;24;104;60;164
66;0;12,5;Sans activité;Employés;D;6;AR;70,6;69,2;10;42;26;31;26;68;57;125
67;0;12,8;Ouvrier;Ouvrier;D;6;AR;55,3;60,3;3;45;37;29;31;82;60;142
68;0;11,9;Employés;Intermédiaire;D;6;AN;70,6;55,1;6;52;51;18;24;103;42;145
69;1;11,6;Ouvrier;Employés;D;6;AN;32,9;26,9;19;40;40;17;22;80;39;119
70;1;12,5;CadresProfSup;Ouvrier;D;6;AR;62,4;39,7;6;62;49;20;28;111;48;159
71;0;12,2;Ouvrier;Sans activité;D;6;AN;54,1;46,2;2;42;43;30;28;85;58;143
72;0;12;Retraité;Employés;D;6;AN;64,7;79,5;11;50;43;26;29;93;55;148
73;1;12,3;Ouvrier;Intermédiaire;D;6;AN;70,6;75,6;8;65;49;34;33;114;67;181
76;1;11,9;Ouvrier;Employés;D;6;AN;65,9;60,3;8;65;46;31;32;111;63;174
77;1;11,8;CadresProfSup;Ouvrier;D;6;AN;76,6;66,7;19;68;69;29;31;137;60;197
79;0;11,7;CadresProfSup;Sans activité;D;6;AN;84,7;87,2;13;78;80;41;35;158;76;234
81;1;11,8;ArtCommPME;ArtCommPME;E;6;AN;49,4;59,7;49;40;29;22;13;69;35;104
83;0;11,8;Employés;Employés;E;6;AN;80,5;81,8;49;70;71;34;39;141;73;214
84;0;11,8;Ouvrier;Employés;E;6;AN;66,7;54,5;49;40;26;25;18;66;43;109
85;0;12,1;CadresProfSup;Ouvrier;E;6;AN;71,3;66;49;80;77;42;39;157;81;238
87;0;11,5;Ouvrier;Sans activité;E;6;AN;54;63,6;56;52;37;12;16;89;28;117
88;1;12,6;ArtCommPME;Ouvrier;E;6;AR;35,6;34;56;42;26;16;17;68;33;101
89;0;11,7;Employés;Sans activité;E;6;AN;63,2;33,8;56;55;37;29;25;92;54;146
90;0;12,2;Ouvrier;Sans activité;E;6;AN;74,7;93,5;56;75;80;36;31;155;67;222
91;1;12;Ouvrier;ArtCommPME;E;6;AN;79,3;89,6;27;65;49;31;37;114;68;182
92;1;12;ArtCommPME;Intermédiaire;E;6;AN;85,5;85,7;27;70;46;35;31;116;66;182
93;0;11,8;Employés;ArtCommPME;E;6;AN;73,6;49,4;27;45;40;34;37;85;71;156
94;0;12,5;Employés;Sans activité;E;6;AN;66,7;58,4;27;32;14;21;25;46;46;92
95;1;11,5;Ouvrier;Sans activité;E;6;AN;89,7;88,3;27;70;63;42;37;133;79;212
96;1;11,6;Sans activité;Employés;E;6;AN;41,4;42,9;58;38;29;26;19;67;45;112
97;1;12,5;ArtCommPME;Sans activité;E;6;AR;65,5;51,9;58;60;54;24;32;114;56;170
98;1;11,8;Sans activité;Sans activité;E;6;AN;77;59,7;58;25;31;27;38;56;65;121
99;1;12,2;ArtCommPME;Intermédiaire;E;6;AN;66,7;54,5;58;70;54;16;26;124;42;166
100;0;11,7;Employés;ArtCommPME;E;6;AN;67,8;57,1;58;58;43;15;23;101;38;139
101;1;12,2;Agriculteur;Agriculteur;E;6;AN;66,7;49,4;52;70;54;26;26;124;52;176
102;1;12,2;CadresProfSup;Employés;E;6;AN;77;85,7;52;72;49;35;37;121;72;193
103;0;9,9;Intermédiaire;Ouvrier;E;6;AN;89,7;92,2;52;62;74;40;33;136;73;209
104;0;13,8;Employés;Sans activité;E;6;AR;56,3;64,9;52;32;20;16;14;52;30;82
105;0;11,6;ArtCommPME;Sans activité;E;6;AN;57,5;66,2;52;48;49;32;19;97;51;148
106;1;11,3;Intermédiaire;Employés;E;6;AN;72,9;69,2;15;62;40;38;44;102;82;184
107;1;11;Employés;Employés;E;6;AN;43,5;42,3;14;38;31;17;13;69;30;99
108;1;10,8;Intermédiaire;Intermédiaire;E;6;AN;74,1;74,4;17;58;34;21;39;92;60;152
109;0;10,8;Ouvrier;Ouvrier;E;6;AN;47,1;50;17;52;43;22;32;95;54;149
110;0;12,4;Ouvrier;Sans activité;E;6;AN;61,2;57,7;21;35;31;32;24;66;56;122
111;1;11,4;Ouvrier;Sans activité;E;6;AN;67,1;69,2;12;58;46;20;31;104;51;155
112;1;10,9;Intermédiaire;Employés;E;6;AN;48,2;55,1;19;80;71;30;43;151;73;224
113;1;11,9;Ouvrier;Ouvrier;E;6;AN;50,6;42,3;8;65;46;26;25;111;51;162
114;0;11,3;Employés;Intermédiaire;E;6;AN;92,9;96,2;19;85;80;44;42;165;86;251
115;0;10,6;Agriculteur;Intermédiaire;E;6;AN;76,5;91;8;75;74;40;37;149;77;226
116;1;11,6;Employés;Employés;E;6;AN;59,8;32,5;1;55;49;19;25;104;44;148
117;0;10,5;Employés;Ouvrier;E;6;AN;74,1;57,1;1;50;46;28;30;96;58;154
118;1;11,8;Sans activité;Ouvrier;E;6;AN;58,8;51,3;1;32;34;16;20;66;36;102
119;0;11,2;Ouvrier;Sans activité;E;6;AN;72,9;56,4;1;50;40;26;36;90;62;152
120;1;10,6;Intermédiaire;Intermédiaire;E;6;AN;80;83,3;8;80;80;40;31;160;71;231
121;0;11,1;Ouvrier;Sans activité;E;6;AN;47,7;33,3;8;35;11;17;7;46;24;70
122;1;10,2;Ouvrier;Employés;E;6;AN;87,1;92,3;15;75;89;24;30;164;54;218
123;1;10,5;Ouvrier;Employés;E;6;AN;40;51,3;7;30;17;16;9;47;25;72
124;0;10,8;Employés;Sans activité;E;6;AN;82,4;93,6;21;78;74;40;43;152;83;235
125;1;11,2;Employés;Sans activité;E;6;AN;74,1;79,5;17;65;63;28;22;128;50;178
126;1;11,4;Employés;Employés;E;6;AN;75,3;60,3;14;58;49;25;31;107;56;163
127;0;10,9;Employés;Employés;E;6;AN;82,4;75;19;70;66;26;35;136;61;197
128;1;11,8;Employés;Employés;E;6;AN;47,1;60,3;19;58;46;24;29;104;53;157
129;1;10,1;Ouvrier;Sans activité;E;6;AN;67,1;59;22;80;63;36;31;143;67;210
130;1;12,2;Ouvrier;Sans activité;E;6;AN;41,2;38,5;20;35;14;16;15;49;31;80
131;1;10,6;Ouvrier;Sans activité;E;6;AN;40;57,7;12;40;9;20;20;49;40;89
132;1;12;ArtCommPME;Sans activité;E;6;AN;60;65,4;22;58;46;18;28;104;46;150
133;0;11,2;Intermédiaire;Intermédiaire;E;6;AN;72,9;50;22;72;46;36;27;118;63;181
134;0;12,8;Intermédiaire;Intermédiaire;A;5;AN;72,7;56,9;37;78;49;38;27;127;65;192
135;0;13,1;ArtCommPME;Employés;A;5;AR;75,8;43,1;37;58;43;29;30;101;59;160
136;1;14,5;Sans activité;Sans activité;A;5;AR;66,7;44,8;37;80;77;33;26;157;59;216
137;1;12,9;Ouvrier;ArtCommPME;A;5;AN;81,8;37,9;37;52;49;23;20;101;43;144
138;0;14,1;Sans activité;Sans activité;A;5;AR;60,6;19;40;32;29;16;7;61;23;84
139;1;13,5;Retraité;Employés;A;5;AR;69,7;69;40;65;46;26;34;111;60;171
140;1;12,8;CadresProfSup;CadresProfSup;A;5;AN;78,8;72,8;40;88;57;39;38;145;77;222
141;1;12,7;Employés;Sans activité;A;5;AN;78,8;72,4;45;55;51;37;35;106;72;178
142;1;13,5;Ouvrier;Sans activité;A;5;AR;63,6;46,6;45;52;34;29;30;86;59;145
143;0;12,2;CadresProfSup;Sans activité;A;5;AN;78,8;39,7;45;88;89;26;31;177;57;234
144;0;12,6;Retraité;Intermédiaire;A;5;AN;69,7;24,1;45;50;26;24;30;76;54;130
145;0;13,4;Employés;Employés;A;5;AR;90,9;32,8;46;58;51;33;34;109;67;176
146;0;12,8;Ouvrier;Sans activité;A;5;AN;90,9;62,1;46;65;29;26;32;94;58;152
147;1;13,5;Employés;Sans activité;A;5;AR;69,7;32,8;46;25;6;19;14;31;33;64
148;1;14;Employés;Sans activité;A;5;AR;63,6;36,2;46;35;14;17;17;49;34;83
149;0;12,6;Employés;Employés;A;5;AN;69,7;51,7;47;50;51;24;28;101;52;153
150;0;14,2;Ouvrier;Sans activité;A;5;AR;60,6;43,1;47;52;29;23;25;81;48;129
151;0;12,3;Ouvrier;Sans activité;A;5;AN;84,8;34,5;47;78;51;36;38;129;74;203
152;1;12,2;Employés;Employés;A;5;AN;78,8;74,1;47;50;49;27;30;99;57;156
154;1;12,9;Agriculteur;Agriculteur;A;5;AN;90,9;75,9;31;70;80;33;37;150;70;220
156;1;12,6;Employés;Sans activité;A;5;AN;57,1;56,9;32;52;49;34;33;101;67;168
157;1;12,8;Sans activité;Sans activité;A;5;AN;54,5;44,8;39;72;23;40;31;95;71;166
158;1;14;Employés;Employés;A;5;AR;57,6;65,5;38;72;60;30;32;132;62;194
159;0;13,7;ArtCommPME;ArtCommPME;A;5;AR;54,5;31;33;45;26;34;30;71;64;135
160;1;12,2;Ouvrier;CadresProfSup;A;5;AN;75,8;81;36;52;34;40;36;86;76;162
161;1;14;Sans activité;Intermédiaire;A;5;AR;72,7;50;38;65;49;40;38;114;78;192
162;1;12,7;Sans activité;Employés;A;5;AN;57,6;29,3;32;45;51;22;24;96;46;142
163;0;12,4;Agriculteur;Sans activité;A;5;AN;84,8;56,9;31;70;60;30;30;130;60;190
164;1;14,2;Employés;Sans activité;A;5;AR;48,5;25,9;39;72;80;23;41;152;64;216
165;0;14,4;Employés;Employés;A;5;AR;51,5;31;33;48;40;30;22;88;52;140
166;1;12,2;Intermédiaire;Employés;A;5;AN;69,7;43,1;32;50;40;34;33;90;67;157
167;0;13,5;Employés;Employés;A;5;AR;63,6;25,9;33;40;17;22;19;57;41;98
168;0;13,4;Employés;Intermédiaire;A;5;AR;27,3;31;39;38;31;24;24;69;48;117
169;1;13,6;Sans activité;Sans activité;A;5;AR;39,4;48,3;31;40;23;22;19;63;41;104
171;1;12,8;CadresProfSup;Intermédiaire;C;5;AN;65;74;29;68;74;38;42;142;80;222
173;1;12,6;Ouvrier;Ouvrier;C;5;AN;68;53;29;50;46;24;35;96;59;155
174;0;12,6;Employés;Ouvrier;C;5;AN;80;62;29;50;51;16;26;101;42;143
177;0;12,9;Intermédiaire;Employés;C;5;AN;88;56;29;65;54;19;38;119;57;176
178;0;13,5;Intermédiaire;Intermédiaire;E;5;AN;91,3;76,7;50;78;66;42;41;144;83;227
179;0;12,9;CadresProfSup;Sans activité;E;5;AN;85,9;90,4;50;72;66;40;31;138;71;209
180;0;12,6;ArtCommPME;Employés;E;5;AN;67,4;71,2;59;42;29;18;15;71;33;104
181;1;12,7;Ouvrier;Employés;E;5;AN;87;84,9;59;70;69;36;37;139;73;212
182;0;14;Intermédiaire;Intermédiaire;E;5;AR;75;86,3;59;72;71;33;39;143;72;215
183;1;12,8;Ouvrier;Employés;E;5;AN;77,2;63;59;65;51;33;37;116;70;186
185;1;13;Employés;Sans activité;E;5;AN;44,6;43,8;53;35;37;14;22;72;36;108
186;1;12,9;ArtCommPME;Employés;E;5;AN;58,7;32,9;53;32;37;22;14;69;36;105
187;1;13,2;Intermédiaire;Employés;E;5;AN;90,2;83,6;53;50;43;33;35;93;68;161
188;0;12,7;ArtCommPME;Intermédiaire;E;5;AN;82,6;72,6;53;70;57;38;38;127;76;203
189;1;13,5;Intermédiaire;Employés;E;5;AN;77,2;76,7;53;48;23;29;29;71;58;129
190;0;14,1;Employés;Sans activité;E;5;AR;62;69,9;50;52;46;20;28;98;48;146
191;1;13,6;ArtCommPME;Sans activité;E;5;AR;41,3;39,7;50;42;29;25;20;71;45;116
192;0;12,6;Employés;Employés;E;5;AN;70,7;71,2;51;58;31;30;32;89;62;151
193;1;13,3;Employés;Sans activité;E;5;AN;84,8;76,7;51;65;57;40;37;122;77;199
194;1;14;Sans activité;Sans activité;E;5;AR;39,1;38,4;51;28;3;11;17;31;28;59
195;0;12,2;Employés;Ouvrier;E;5;AN;84,8;61,6;51;55;43;32;31;98;63;161
196;1;12,8;Employés;Employés;E;5;AN;68,5;71,2;51;55;54;32;39;109;71;180
197;1;15;Ouvrier;Employés;D;5;AR;34,8;24,7;10;50;29;10;20;79;30;109
198;0;12,5;Ouvrier;CadresProfSup;D;5;AN;70,1;61;18;65;54;24;33;119;57;176
199;0;13,7;ArtCommPME;Employés;D;5;AR;56,3;55,8;6;52;31;15;22;83;37;120
201;1;12,7;Employés;Intermédiaire;D;5;AN;77;89,6;11;42;54;30;31;96;61;157
202;1;12,7;Ouvrier;Employés;D;5;AN;52,9;64,7;9;42;43;25;28;85;53;138
203;0;13,2;Ouvrier;Ouvrier;D;5;AN;65,5;40,3;9;28;14;23;24;42;47;89
204;0;13;Intermédiaire;Sans activité;D;5;AN;74,4;84,4;3;48;31;35;40;79;75;154
205;0;13,1;ArtCommPME;ArtCommPME;D;5;AN;67,8;72,7;18;62;49;30;32;111;62;173
206;1;12,9;Intermédiaire;Employés;D;5;AN;40,2;36,4;5;48;26;16;22;74;38;112
207;1;13,6;ArtCommPME;Employés;D;5;AR;44,4;29,9;5;65;54;35;33;119;68;187
208;0;13;CadresProfSup;Employés;D;5;AN;77;64,9;6;72;71;38;35;143;73;216
209;0;13,2;Employés;CadresProfSup;D;5;AN;63,2;71,4;11;55;40;29;28;95;57;152
210;0;12,8;Ouvrier;Sans activité;D;5;AN;69;61;4;68;49;16;28;117;44;161
211;1;14;CadresProfSup;Employés;D;5;AR;62,1;76,6;2;50;31;37;37;81;74;155
212;1;14,2;Ouvrier;Employés;D;5;AR;54;49,4;4;30;20;20;16;50;36;86
213;1;9,5;CadresProfSup;Intermédiaire;D;5;AN;63,2;70,1;2;48;49;31;29;97;60;157
214;1;12,6;Ouvrier;Sans activité;D;5;AN;54;62,3;13;58;43;23;19;101;42;143
215;0;12,9;CadresProfSup;Employés;D;5;AN;81,6;57,1;13;62;60;30;28;122;58;180
216;1;13,1;Ouvrier;Employés;D;5;AN;88,5;96,1;3;80;83;42;42;163;84;247
217;0;12,8;CadresProfSup;CadresProfSup;E;5;AN;88,5;85,7;15;90;97;38;38;187;76;263
218;0;13;Intermédiaire;Intermédiaire;E;5;AN;94,3;76,6;20;62;57;34;41;119;75;194
219;0;12,5;Intermédiaire;Intermédiaire;E;5;AN;83,5;55,8;22;68;43;37;31;111;68;179
220;1;13,2;CadresProfSup;ArtCommPME;E;5;AN;77;85,7;22;85;71;34;38;156;72;228
221;1;13,2;Intermédiaire;Intermédiaire;E;5;AN;70,1;67,5;22;65;39;36;33;104;69;173
222;1;13,2;Employés;Employés;E;5;AN;67,8;92,2;14;75;77;30;35;152;65;217
223;1;13;Intermédiaire;Employés;E;5;AN;64,4;68,8;21;82;77;31;33;159;64;223
224;0;14,8;Ouvrier;Sans activité;E;5;AR;57,6;50,7;7;55;37;18;28;92;46;138
225;0;14,2;Ouvrier;Employés;E;5;AR;34,8;24,7;7;35;20;15;9;55;24;79
226;0;12,6;Ouvrier;Employés;E;5;AN;57,5;66,2;21;82;66;44;37;148;81;229
227;1;13,2;Employés;Sans activité;E;5;AN;67,8;76,6;17;82;71;23;38;153;61;214
228;1;12,5;Intermédiaire;Intermédiaire;E;5;AN;75,9;85,7;17;75;74;40;42;149;82;231
229;0;12,5;Intermédiaire;Intermédiaire;E;5;AN;83,9;67,5;17;80;71;30;41;151;71;222
230;0;12,5;Ouvrier;Ouvrier;E;5;AN;72,4;71,4;8;60;57;26;31;117;57;174
231;0;13;Employés;Intermédiaire;E;5;AN;85,1;76,6;8;75;94;46;44;169;90;259
232;1;12,8;ArtCommPME;Intermédiaire;E;5;AN;59,8;66,2;19;78;69;34;40;147;74;221
233;1;13,8;ArtCommPME;Sans activité;E;5;AR;54,3;53,4;1;35;26;6;11;61;17;78
234;0;12,5;Ouvrier;Ouvrier;E;5;AN;81,6;87;1;72;71;22;23;143;45;188
235;1;12,8;Ouvrier;Sans activité;E;5;AN;52,9;49,4;1;48;34;22;33;82;55;137
236;0;12,8;Intermédiaire;Intermédiaire;E;5;AN;80,5;81,8;1;85;83;32;44;168;76;244
237;1;14,3;Intermédiaire;Intermédiaire;E;5;AR;82,6;72,6;15;70;60;38;44;130;82;212
238;1;14,3;Intermédiaire;Intermédiaire;E;5;AR;44,8;62,3;20;62;37;22;17;99;39;138
239;0;13,9;CadresProfSup;Sans activité;B;4;AN;93,1;96,5;44;88;94;40;42;182;82;264
240;1;13,8;Ouvrier;Ouvrier;B;4;AN;80,5;80,2;35;32;23;29;30;55;59;114
241;0;13,5;Employés;Employés;B;4;AN;75,9;62,8;35;55;43;32;41;98;73;171
242;0;13,9;Sans activité;Employés;B;4;AN;59,8;50;43;60;46;36;38;106;74;180
243;1;13,9;Employés;Intermédiaire;B;4;AN;78,2;83,7;43;52;66;41;42;118;83;201
244;0;13,8;Intermédiaire;Sans activité;B;4;AN;84;85;43;82;83;42;38;165;80;245
245;1;13,9;Sans activité;ArtCommPME;B;4;AN;69;86;44;45;31;30;33;76;63;139
246;1;13,9;Employés;Intermédiaire;B;4;AN;73,6;79,1;44;35;26;31;22;61;53;114
247;0;13,8;ArtCommPME;Intermédiaire;B;4;AN;77;62,8;44;70;80;38;39;150;77;227
248;0;13,9;Employés;ArtCommPME;B;4;AN;73,6;82,6;42;70;63;32;34;133;66;199
249;0;13,8;Intermédiaire;Intermédiaire;B;4;AN;72,4;75,6;42;62;60;38;26;122;64;186
250;1;13,5;Employés;Sans activité;B;4;AN;79,3;91,9;41;75;74;25;33;149;58;207
251;0;13,6;Intermédiaire;Sans activité;B;4;AN;78,2;75,6;41;65;57;30;30;122;60;182
252;0;13,7;CadresProfSup;ArtCommPME;B;4;AN;83,9;80,2;35;82;83;46;45;165;91;256
253;1;14,2;Employés;Employés;B;4;AN;82,8;86;35;48;43;38;33;91;71;162
254;0;13,5;Employés;Sans activité;B;4;AN;75,9;77,9;35;78;74;44;44;152;88;240
255;1;13,9;Employés;ArtCommPME;B;4;AN;79,3;94,2;35;70;34;34;31;104;65;169
256;1;13,1;Intermédiaire;Intermédiaire;B;4;AN;55,2;61;36;75;57;28;40;132;68;200
257;0;14,6;Sans activité;Sans activité;B;4;AR;57,5;53,5;43;45;34;22;22;79;44;123
258;1;14,2;Employés;Sans activité;B;4;AN;66,7;70,9;43;68;46;27;35;114;62;176
259;0;13,6;Ouvrier;Employés;B;4;AN;73,6;48,8;44;72;77;37;34;149;71;220
260;0;15,1;Employés;Employés;B;4;AR;78,2;76,7;44;65;34;18;28;99;46;145
261;1;13,6;Employés;Employés;B;4;AN;65,5;58,1;44;65;41;24;33;106;57;163
262;0;13,2;Employés;Sans activité;B;4;AN;57,5;69,8;44;82;97;38;40;179;78;257
263;1;13,4;CadresProfSup;Intermédiaire;B;4;AN;58,6;70,9;44;65;49;25;36;114;61;175
264;1;13,2;Employés;Intermédiaire;B;4;AN;64,4;81,4;42;42;34;21;50;76;71;147
265;1;13,3;Employés;Employés;B;4;AN;77;76,7;42;70;83;34;43;153;77;230
266;0;13,8;Ouvrier;Employés;B;4;AN;62;75,5;41;58;46;36;38;104;74;178
267;1;13,3;Intermédiaire;Intermédiaire;B;4;AN;70,1;79,1;41;60;40;28;27;100;55;155
268;1;14,2;Intermédiaire;Intermédiaire;B;4;AR;70,1;46,5;41;90;69;26;31;159;57;216
269;1;13,4;Employés;Sans activité;B;4;AN;51,7;68,7;42;42;34;24;24;76;48;124
270;0;14,7;Employés;Employés;B;4;AR;67,8;41,9;35;58;34;27;36;92;63;155
271;0;13,6;Intermédiaire;Intermédiaire;E;4;AN;80,5;75,6;57;52;49;29;28;101;57;158
272;0;14;CadresProfSup;CadresProfSup;E;4;AN;87,4;81,4;57;80;86;40;44;166;84;250
273;0;13,9;Ouvrier;Intermédiaire;E;4;AN;63,2;50;57;45;31;23;11;76;34;110
274;0;14,1;Intermédiaire;Intermédiaire;E;4;AN;83,9;87,2;57;58;60;31;32;118;63;181
277;1;14,6;CadresProfSup;Intermédiaire;E;4;AR;48,3;39,8;52;82;80;28;32;162;60;222
278;1;14;Ouvrier;Sans activité;E;4;AN;40,2;51,2;52;60;23;24;23;83;47;130
279;0;14;Intermédiaire;Intermédiaire;E;4;AN;93,1;77,9;54;62;66;48;40;128;88;216
280;0;14,4;Employés;Employés;E;4;AN;58,6;55,8;54;42;29;23;28;71;51;122
281;1;14,2;Intermédiaire;Sans activité;E;4;AN;85,1;95,3;54;85;77;38;40;162;78;240
282;1;14,1;Employés;Ouvrier;E;4;AN;60,9;65,9;54;70;69;26;24;139;50;189
283;0;13,9;Agriculteur;Ouvrier;E;4;AN;51,7;60,5;54;38;31;26;30;69;56;125
285;0;13,7;CadresProfSup;CadresProfSup;E;4;AN;88,5;79,1;51;95;94;44;44;189;88;277
286;0;14,2;Employés;ArtCommPME;E;4;AN;62,1;70,9;51;60;46;32;30;106;62;168
287;1;14,7;ArtCommPME;Sans activité;E;4;AR;35,6;11,6;51;55;37;12;19;92;31;123
288;0;13,8;CadresProfSup;Intermédiaire;E;4;AN;87,4;87,2;53;60;66;23;34;126;57;183
289;1;14,4;Ouvrier;Employés;E;4;AN;54;44,2;53;65;43;14;25;108;39;147
290;0;13,6;Ouvrier;Intermédiaire;E;4;AN;70,1;57;53;65;46;27;27;111;54;165
291;0;14,3;Intermédiaire;Intermédiaire;E;4;AN;74,7;66,3;53;65;49;34;34;114;68;182
292;1;15,3;Ouvrier;Employés;E;4;AR;88,5;76,1;56;95;91;34;44;186;78;264
293;0;13,2;CadresProfSup;Intermédiaire;D;4;AN;93,5;90,4;10;88;77;42;43;165;85;250
294;0;15,2;Ouvrier;Employés;D;4;AR;87,1;92,3;15;75;86;24;30;161;54;215
295;0;14,2;CadresProfSup;CadresProfSup;D;4;AN;91,3;76,7;5;95;94;48;44;189;92;281
296;0;14,2;ArtCommPME;CadresProfSup;D;4;AN;88;94;9;85;63;34;44;148;78;226
297;0;12,8;CadresProfSup;Intermédiaire;D;4;AN;94,6;95,9;18;92;97;46;42;189;88;277
298;0;14,1;CadresProfSup;CadresProfSup;D;4;AN;90,2;76;7;85;91;42;40;176;82;258
299;0;14,1;CadresProfSup;CadresProfSup;D;4;AN;92,4;86,3;13;88;94;38;37;182;75;257
301;0;13,9;Employés;Ouvrier;D;4;AN;63;49,3;13;60;40;36;30;100;66;166
302;1;15,5;Ouvrier;Sans activité;D;4;AR;71,7;67,1;9;40;34;31;20;74;51;125
303;0;14,6;Intermédiaire;Employés;D;4;AR;57,5;37,2;9;55;37;28;30;92;58;150
304;1;13,5;CadresProfSup;CadresProfSup;D;4;AN;65,2;74;8;55;31;30;32;86;62;148
305;1;13,7;Ouvrier;Sans activité;D;4;AN;78,3;74;8;40;43;29;26;83;55;138
306;1;14,7;Intermédiaire;Intermédiaire;D;4;AR;66,7;70,9;2;55;46;34;41;101;75;176
307;1;13,9;CadresProfSup;Employés;D;4;AN;78,3;64,4;18;60;43;24;29;103;53;156
308;1;14,4;Employés;Employés;D;4;AN;60,9;65,8;11;68;69;17;26;137;43;180
309;1;14,3;Ouvrier;Sans activité;D;4;AN;71,7;63;3;52;57;17;25;109;42;151
310;0;14;Intermédiaire;Employés;D;4;AN;76,1;53,4;3;75;54;36;40;129;76;205
311;0;14,7;Intermédiaire;Ouvrier;D;4;AR;65,5;50;3;52;37;30;31;89;61;150
314;0;14,2;Ouvrier;Employés;D;4;AN;79,3;80,8;19;65;69;31;33;134;64;198
315;1;14,6;ArtCommPME;CadresProfSup;D;4;AR;60,9;39,7;19;40;26;17;29;66;46;112
316;1;13,5;Employés;Employés;D;4;AN;78,3;68,5;5;75;71;27;37;146;64;210
317;0;14,5;CadresProfSup;Intermédiaire;D;4;AR;43,5;56,2;11;58;26;17;30;84;47;131
320;0;14,2;Employés;Employés;E;4;AN;65,2;75,3;22;75;43;27;27;118;54;172
321;0;14,4;Ouvrier;Employés;E;4;AN;87;87,7;22;80;69;24;42;149;66;215
322;1;13,8;Ouvrier;Employés;E;4;AN;71,7;41,3;15;72;83;34;47;155;81;236
323;1;14,4;Ouvrier;Sans activité;E;4;AN;92,4;83,6;15;85;83;29;22;168;51;219
324;0;14,8;ArtCommPME;Employés;E;4;AR;67,4;58;15;70;71;42;43;141;85;226
325;0;13;ArtCommPME;Sans activité;E;4;AN;76,1;74;7;98;94;42;44;192;86;278
326;1;14,2;Intermédiaire;Intermédiaire;E;4;AN;64,1;75,3;14;45;46;21;28;91;49;140
327;0;13,8;Employés;Employés;E;4;AN;79,3;89;14;60;71;40;32;131;72;203
328;0;13,9;Ouvrier;Ouvrier;E;4;AN;57,6;56,2;17;62;69;23;32;131;55;186
329;1;14,5;Intermédiaire;Ouvrier;E;4;AN;77,2;76,7;17;60;37;26;38;97;64;161
331;0;14;CadresProfSup;Sans activité;E;4;AN;89,1;71,2;21;82;69;46;44;151;90;241
332;0;14,3;Ouvrier;Intermédiaire;E;4;AN;87;93,2;16;78;74;30;35;152;65;217
333;0;14,5;Ouvrier;Employés;E;4;AN;71,7;74;16;72;66;39;41;138;80;218
334;1;13,7;Ouvrier;Employés;E;4;AN;77,2;63;12;75;69;32;32;144;64;208
335;0;14,2;Ouvrier;Sans activité;E;4;AN;72,7;44,8;19;62;63;37;40;125;77;202
336;0;14,3;Sans activité;Sans activité;E;4;AN;70,7;60,3;1;68;60;37;39;128;76;204
337;1;14,4;Ouvrier;Intermédiaire;E;4;AN;79,3;75,3;8;55;54;37;44;109;81;190
338;0;14;Intermédiaire;Intermédiaire;E;4;AN;77,2;80,8;7;78;66;39;38;144;77;221
339;0;12,9;Employés;Ouvrier;E;4;AN;92,4;94,5;20;82;74;44;44;156;88;244
340;1;14,2;Ouvrier;Employés;E;4;AN;50;60,3;20;55;49;38;30;104;68;172
341;0;13,6;ArtCommPME;Employés;E;4;AN;70,7;71,2;7;78;57;37;31;135;68;203
342;0;14;Ouvrier;Sans activité;E;4;AN;84,8;72,6;7;78;71;42;31;149;73;222
343;0;14,2;Intermédiaire;CadresProfSup;E;4;AN;91,3;72,6;20;62;49;30;41;111;71;182
344;1;13,7;Ouvrier;Employés;E;4;AN;87;84,9;20;75;80;34;42;155;76;231
345;0;16,1;ArtCommPME;Sans activité;E;3;AR;49,4;60,2;55;58;71;22;35;129;57;186
347;1;16,2;Intermédiaire;Employés;E;3;AR;60,2;45,1;55;78;77;34;39;155;73;228
348;0;15,8;ArtCommPME;Intermédiaire;E;3;AR;60,9;65,9;55;80;83;25;39;163;64;227
349;1;15,2;ArtCommPME;Intermédiaire;E;3;AN;58,6;68,2;55;62;63;20;31;125;51;176
350;1;15,2;ArtCommPME;Intermédiaire;E;3;AN;58,6;68,2;55;62;63;20;31;125;51;176
351;1;14,7;Intermédiaire;Employés;E;3;AN;62,1;64,8;50;55;54;23;25;109;48;157
352;1;15,7;Employés;Employés;E;3;AR;67;75,6;50;78;71;38;38;149;76;225
353;0;16,2;ArtCommPME;Ouvrier;E;3;AR;46;46,6;50;45;17;8;23;62;31;93
354;1;14,8;Ouvrier;Sans activité;E;3;AN;64,4;44,3;50;68;43;37;41;111;78;189
355;1;14,8;Ouvrier;Sans activité;E;3;AN;71,3;47,7;55;75;83;37;43;158;80;238
357;0;16,4;ArtCommPME;Sans activité;E;3;AR;55,7;65,9;49;68;51;37;29;119;66;185
358;0;14,8;Employés;Retraité;E;3;AN;70,1;78,4;49;72;54;36;35;126;71;197
359;0;14,6;Employés;Employés;E;3;AN;75,9;67;49;60;60;38;30;120;68;188
360;0;15,6;Employés;Sans activité;E;3;AR;49,4;50;27;65;49;31;36;114;67;181
362;0;14,3;Intermédiaire;Intermédiaire;E;3;AN;82,8;78,4;27;55;57;38;37;112;75;187
363;1;16,1;Ouvrier;Sans activité;E;3;AR;29,5;18,3;25;82;69;29;38;151;67;218
364;0;15;Ouvrier;Sans activité;E;3;AN;62,1;38,6;27;60;37;31;39;97;70;167
365;1;14,9;Ouvrier;Sans activité;E;3;AN;52,9;45,5;27;58;40;33;31;98;64;162
366;0;15,3;Ouvrier;Sans activité;E;3;AN;41,4;60,2;56;80;71;44;34;151;78;229
368;0;14,5;Intermédiaire;Intermédiaire;E;3;AN;78,2;75,6;30;90;100;46;44;190;90;280
369;1;14,7;Intermédiaire;Intermédiaire;B;3;AN;62,1;38,4;32;70;77;38;41;147;79;226
370;1;14,7;Intermédiaire;Intermédiaire;B;3;AN;70,1;59,3;39;60;51;32;43;111;75;186
371;0;15,2;ArtCommPME;Sans activité;B;3;AR;78,2;67,4;36;72;57;40;38;129;78;207
372;1;15,5;Ouvrier;Sans activité;B;3;AR;52,9;51,2;36;40;29;28;28;69;56;125
373;0;15,2;Employés;Employés;B;3;AR;51;60,4;39;75;69;36;39;144;75;219
374;1;15,2;Intermédiaire;Intermédiaire;B;3;AR;70,1;46,5;32;82;86;36;34;168;70;238
375;1;15,2;Sans activité;Sans activité;B;3;AR;60,9;68,6;39;60;46;26;35;106;61;167
376;1;15,8;Ouvrier;Sans activité;B;3;AR;77;68,6;36;85;89;44;39;174;83;257
377;1;15,4;Intermédiaire;Sans activité;C;3;AN;44,8;44,3;25;50;34;23;24;84;47;131
378;0;14,8;Ouvrier;Ouvrier;C;3;AN;49,4;54,5;25;75;63;26;37;138;63;201
379;1;14,8;CadresProfSup;Employés;C;3;AN;75,9;69,3;25;98;100;32;50;198;82;280
380;1;14,8;Employés;Intermédiaire;C;3;AN;60,9;46,6;25;58;49;34;44;107;78;185
381;1;14,7;CadresProfSup;Intermédiaire;C;3;AN;63,2;87,5;25;85;83;40;46;168;86;254
382;0;14,6;ArtCommPME;Employés;C;3;AN;74,7;75;28;90;94;40;44;184;84;268
384;0;14,9;Employés;Employés;C;3;AN;64,4;64,8;28;60;43;33;38;103;71;174
385;0;15,2;Ouvrier;Ouvrier;C;3;AN;66,7;60,2;28;68;71;42;41;139;83;222
386;1;16;Ouvrier;Ouvrier;C;3;AR;52,3;44,3;28;50;43;10;24;93;34;127
387;0;14,8;Intermédiaire;Intermédiaire;C;3;AN;74,7;62,5;28;80;69;29;30;149;59;208
388;0;14,8;Employés;Ouvrier;C;3;AN;48,3;46,6;24;52;40;26;22;92;48;140
390;0;14,6;CadresProfSup;Intermédiaire;C;3;AN;51,7;53,4;24;62;46;29;35;108;64;172
391;1;15,4;Ouvrier;Employés;C;3;AN;71,3;77,3;24;75;71;36;43;146;79;225
392;0;14,8;Ouvrier;Ouvrier;C;3;AN;67,8;89,8;24;60;63;34;46;123;80;203
393;0;15,4;Intermédiaire;Sans activité;C;3;AN;44,8;47,7;23;58;40;30;37;98;67;165
394;0;14,6;Ouvrier;Employés;C;3;AN;74,7;67;23;75;49;32;37;124;69;193
395;0;14,8;Ouvrier;Ouvrier;C;3;AN;81,6;87,5;23;85;86;46;43;171;89;260
396;1;14,8;CadresProfSup;Sans activité;C;3;AN;69;60,2;23;82;69;42;44;151;86;237
397;1;14,5;Employés;Ouvrier;C;3;AN;63,2;60,2;23;82;77;33;31;159;64;223
398;1;15,6;Employés;Employés;C;3;AR;47,1;40,9;26;78;40;23;26;118;49;167
399;0;15,2;ArtCommPME;Intermédiaire;C;3;AN;51,7;53,4;26;90;100;38;38;190;76;266
400;1;15;Ouvrier;Intermédiaire;C;3;AN;64,4;65,9;26;68;54;35;42;122;77;199
401;1;14,5;Employés;Ouvrier;C;3;AN;88,5;87,5;26;100;91;50;46;191;96;287
402;1;14,8;CadresProfSup;Intermédiaire;C;3;AN;85,1;81,8;26;88;86;46;46;174;92;266
403;0;14,9;Intermédiaire;CadresProfSup;C;3;AN;74,7;67,4;8;90;94;46;46;184;92;276
405;0;15,3;ArtCommPME;ArtCommPME;D;3;AN;54;37,2;4;45;31;21;26;76;47;123
406;1;15,3;CadresProfSup;Intermédiaire;D;3;AN;77;77,9;6;85;86;26;34;171;60;231
407;1;15,3;Ouvrier;Sans activité;D;3;AN;66,7;90,7;9;48;34;26;33;82;59;141
408;1;16,8;Ouvrier;Intermédiaire;D;3;AR;72,4;50;9;98;100;38;44;198;82;280
409;1;14,2;Ouvrier;Employés;D;3;AN;83,9;90,7;3;92;100;41;39;192;80;272
411;0;14,8;Intermédiaire;Employés;D;3;AN;72,4;51,2;19;80;71;34;33;151;67;218
412;0;14,7;Intermédiaire;CadresProfSup;E;3;AN;93,1;93;15;90;100;44;43;190;87;277
414;1;15,7;Ouvrier;Sans activité;E;3;AR;35,6;11,6;22;65;39;11;29;104;40;144
415;0;14,9;Employés;Intermédiaire;E;3;AN;95,4;68,8;14;85;80;42;38;165;80;245
416;0;15,2;Intermédiaire;Sans activité;E;3;AN;62,1;70,9;8;75;69;34;30;144;64;208
417;1;15;Intermédiaire;Intermédiaire;E;3;AN;86,2;76,7;15;98;94;46;49;192;95;287
418;0;14,4;Intermédiaire;Intermédiaire;E;3;AN;67,8;82,6;12;90;91;40;44;181;84;265
419;1;15,5;ArtCommPME;Sans activité;E;3;AR;66,7;51,1;20;82;71;38;34;153;72;225
420;0;14,6;Ouvrier;Sans activité;E;3;AN;87,4;62,5;21;85;71;40;44;156;84;240
421;0;15;Employés;Employés;E;3;AN;85,3;84,9;16;82;86;40;41;168;81;249
422;0;15,5;Sans activité;Sans activité;E;3;AR;63,2;62,8;7;82;83;37;32;165;69;234
423;0;15,2;Intermédiaire;Sans activité;E;3;AN;79,3;75,6;17;60;57;32;35;117;67;184
424;0;15;Employés;Ouvrier;E;3;AN;64,4;51,2;17;65;43;31;38;108;69;177
425;0;15;Intermédiaire;Intermédiaire;E;3;AN;93,1;77,9;17;85;83;44;42;168;86;254
426;1;14,8;Intermédiaire;Employés;E;3;AN;85,1;83,7;22;75;66;38;39;141;77;218
427;0;15,1;Employés;Employés;E;3;AN;74,7;62,8;19;68;66;26;35;134;61;195
428;0;14,8;Agriculteur;Employés;E;3;AN;51,7;60,5;7;45;37;36;27;82;63;145
429;1;15,9;Retraité;Sans activité;E;3;AR;35,6;48,8;21;48;34;27;33;82;60;142
430;1;16,7;Ouvrier;Sans activité;E;3;AR;53,5;39,6;1;45;29;23;29;74;52;126
431;1;14,7;Employés;Employés;E;3;AN;34,5;44,2;19;30;26;29;15;56;44;100
432;0;14,7;Intermédiaire;Employés;E;3;AN;72,4;43,8;12;72;54;36;36;126;72;198
433;1;15,2;Employés;Employés;E;3;AN;88,5;87,5;1;78;86;35;43;164;78;242
